gene	bovis_call	mtb_call
35kd_ag	GA	NE
aac	NE	NE
aao	NE	NE
accA1	NE	NE
accA2	ES	NE
accA3	NE	ES
accD1	NE	NE
accD2	NE	NE
accD3	NE	NE
accD4	ES	ES
accD5	ES	ES
accD6	NE	GD
aceE	ES	NE
ackA	NE	NE
acn	ES	ES
acpA	NE	NE
acpM	ES	ES
acpS	ES	NE
acrA1	NE	NE
acs	NE	NE
acyP	NE	NE
add	NE	NE
adh	NE	NE
adhA	NE	NE
adhB	NE	NE
adhC	NE	NE
adhD	NE	NE
adhE1	NE	NE
adk	NE	NE
aglA	NE	NE
agpS	NE	NE
ahpC	NE	NE
ahpD	NE	NE
ahpE	NE	NE
alaS	NE	ES
aldA	NE	NE
aldC	NE	NE
alkB	NE	GA
alr	NE	ES
amiA1	NE	NE
amiA2	GD	NE
amiB1	NE	NE
amiB2	NE	NE
amiC	ES	NE
amiD	NE	NE
amt	ES	NE
ansA	NE	NE
ansP1	NE	NE
ansP2	ES	NE
aofH	NE	NE
apa	NE	NE
apt	NE	NE
arcA	NE	NE
argB	GD	ES
argC	ES	ES
argD	GD	ES
argF	NE	ES
argG	ES	ES
argH	NE	ES
argJ	ES	ES
argR	ES	NE
argS	ES	ES
aroA	NE	GD
aroB	ES	ES
aroD	ES	ES
aroE	GD	NE
aroF	NE	ES
aroG	NE	ES
aroK	ES	ES
arsA	NE	NE
arsB1	NE	NE
arsB2	NE	NE
arsC	NE	NE
asd	GD	GD
ask	NE	GD
asnB	GD	ES
aspB	NE	NE
aspC	ES	ES
aspS	NE	ES
atpA	ES	ES
atpB	ES	GD
atpC	NE	NE
atpD	ES	ES
atpE	ES	GD
atpF	ES	ES
atpG	ES	ES
atpH	ES	ES
atsB	NE	NE
atsD	NE	NE
bcp	NE	NE
bcpB	ES	NE
betP	NE	NE
bfrA	NE	GA
bfrB	NE	NE
bglS	NE	NE
bioA	NE	NE
bioB	NE	NE
bioD	GD	NE
bioF1	NE	NE
bioF2	NE	NE
birA	ES	NE
bisC	NE	NE
blaC	NE	NE
bpoA	NE	NE
bpoB	NE	NE
bpoC	ES	NE
cadI	NE	NE
carA	ES	ES
carB	ES	ES
cbs	NE	NE
ccdA	ES	ES
ccsA	NE	ES
cdd	NE	NE
cdh	NE	NE
cdsA	GD	ES
celA1	NE	NE
ceoB	NE	NE
ceoC	NE	NE
cfp2	NE	NE
cfp21	NE	GA
cfp29	NE	NE
cfp6	NE	NE
chaA	NE	NE
choD	ES	GA
cinA	NE	NE
citA	NE	NE
citE	GD	NE
clpB	NE	GD
clpP1	NE	GD
clpP2	ES	GD
clpX	NE	ES
cmaA1	NE	NE
cmaA2	NE	GA
cmk	ES	GD
coaA	NE	ES
coaE	NE	GD
cobB	NE	NE
cobC	NE	NE
cobD	NE	NE
cobG	NE	NE
cobH	NE	NE
cobK	NE	NE
cobM	NE	NE
cobN	NE	NE
cobO	NE	NE
cobQ1	NE	NE
cobQ2	GA	ES
cobS	NE	NE
cobT	NE	NE
cobU	NE	NE
corA	NE	NE
cpsY	NE	NE
csd	NE	ES
cspA	NE	NE
cspB	NE	NE
cstA	NE	NE
ctaC	ES	GD
ctaD	NE	GD
ctaE	ES	GD
ctpA	NE	NE
ctpB	NE	NE
ctpC	NE	NE
ctpD	NE	NE
ctpE	NE	NE
ctpF	NE	NE
ctpG	NE	NE
ctpH	NE	NE
ctpI	NE	NE
ctpJ	NE	NE
ctpV	NE	NE
cut2	NE	NE
cut3	NE	NE
cut4	NE	NE
cya	NE	NE
cycA	NE	NE
cydA	NE	NE
cydB	NE	NE
cydC	NE	NE
cydD	NE	NE
cyp121	NE	NE
cyp123	NE	NE
cyp124	NE	NE
cyp125	NE	NE
cyp126	NE	NE
cyp128	NE	NE
cyp132	NE	NE
cyp135A1	NE	NE
cyp135B1	NE	NE
cyp136	NE	GA
cyp137	NE	NE
cyp138	NE	NE
cyp139	NE	NE
cyp140	NE	NE
cyp143	NE	NE
cyp144	NE	NE
cyp51	NE	NE
cysA1	ES	GD
cysA2	NE	GA
cysA3	NE	GA
cysD	ES	NE
cysG	NE	GD
cysH	NE	GD
cysK1	NE	NE
cysK2	NE	NE
cysM	NE	GA
cysQ	NE	NE
cysS1	ES	ES
cysT	ES	GD
cysW	ES	GD
dacB1	NE	NE
dacB2	NE	NE
dapA	NE	GD
dapB	NE	ES
dapE	NE	ES
dapF	NE	ES
dcd	NE	NE
dctA	ES	NE
ddlA	NE	ES
deaD	ES	NE
dedA	NE	NE
def	NE	ES
deoA	NE	NE
deoC	ES	GA
deoD	NE	NE
desA1	NE	ES
desA2	NE	ES
devB	NE	NE
devR	NE	NE
devS	NE	NE
dfp	ES	ES
dfrA	GD	GD
dgt	NE	NE
dhaA	ES	NE
dinF	GD	NE
dinG	NE	NE
dinP	NE	GA
dinX	NE	NE
dipZ	NE	NE
dnaA	ES	ES
dnaB	NE	ES
dnaE1	NE	ES
dnaE2	NE	NE
dnaG	NE	ES
dnaJ1	GA	NE
dnaJ2	NE	GD
dnaK	ES	ES
dnaN	NE	ES
dnaQ	ES	NE
dnaZX	ES	ES
dppA	NE	NE
dppB	NE	NE
dppC	NE	NE
dppD	NE	NE
drrA	NE	GA
drrB	NE	GA
drrC	GA	GA
dsbF	NE	NE
dut	NE	NE
dxr	ES	ES
dxs1	NE	ES
dxs2	NE	NE
echA10	NE	NE
echA11	NE	NE
echA12	NE	NE
echA13	NE	NE
echA14	NE	NE
echA16	NE	NE
echA17	NE	NE
echA18	NE	NE
echA19	NE	NE
echA2	NE	NE
echA20	ES	NE
echA21	NE	NE
echA3	NE	NE
echA4	NE	NE
echA5	NE	NE
echA6	NE	NE
echA7	NE	NE
echA8	NE	NE
echA9	NE	NE
efp	NE	ES
efpA	ES	ES
embA	ES	ES
embB	NE	ES
embC	GD	ES
embR	NE	NE
emrB	NE	NE
end	NE	NE
engA	NE	GD
eno	ES	GD
entC	NE	GD
ephB	NE	NE
ephC	NE	NE
ephD	NE	NE
ephE	GD	NE
era	GD	GD
erg3	NE	NE
esxA	NE	NE
esxB	NE	NE
esxC	NE	NE
esxD	NE	NE
esxE	NE	NE
esxF	NE	NE
esxG	ES	GD
esxH	ES	GD
esxI	NE	GA
esxJ	NE	GA
esxK	GA	GA
esxL	GA	GA
esxN	ES	NE
esxO	NE	GA
esxQ	NE	NE
esxR	NE	NE
esxS	NE	NE
esxT	NE	NE
ethA	NE	NE
ethR	NE	NE
fabD	ES	ES
fabD2	NE	NE
fabG1	ES	ES
fabG2	NE	NE
fabG3	NE	NE
fabG4	NE	NE
fabH	NE	NE
fadA2	ES	NE
fadA3	NE	NE
fadA4	NE	NE
fadA5	NE	NE
fadA6	NE	NE
fadB	NE	NE
fadB2	NE	NE
fadB4	NE	NE
fadB5	NE	NE
fadD1	NE	NE
fadD10	NE	NE
fadD11	NE	NE
fadD12	NE	NE
fadD13	NE	NE
fadD14	NE	NE
fadD15	ES	NE
fadD17	NE	NE
fadD18	NE	NE
fadD19	NE	NE
fadD2	NE	NE
fadD21	NE	NE
fadD22	NE	NE
fadD23	NE	NE
fadD24	NE	NE
fadD25	GA	NE
fadD26	GA	NE
fadD28	NE	NE
fadD29	NE	NE
fadD3	NE	NE
fadD30	GD	NE
fadD31	NE	GA
fadD32	ES	ES
fadD34	NE	NE
fadD35	NE	NE
fadD36	GA	NE
fadD4	NE	NE
fadD5	NE	NE
fadD6	GD	NE
fadD7	ES	NE
fadD8	NE	NE
fadD9	NE	NE
fadE1	NE	NE
fadE10	NE	NE
fadE12	NE	NE
fadE13	NE	NE
fadE15	NE	NE
fadE16	NE	NE
fadE17	NE	NE
fadE18	NE	NE
fadE19	NE	NE
fadE2	NE	GA
fadE20	NE	NE
fadE21	NE	NE
fadE23	NE	NE
fadE24	NE	NE
fadE25	ES	NE
fadE26	NE	NE
fadE27	NE	NE
fadE28	NE	NE
fadE29	GD	NE
fadE30	NE	NE
fadE31	NE	NE
fadE32	NE	NE
fadE33	NE	NE
fadE34	NE	NE
fadE35	NE	NE
fadE36	NE	NE
fadE4	NE	GA
fadE5	NE	NE
fadE6	NE	NE
fadE7	NE	NE
fadE8	NE	NE
fadE9	NE	NE
fadH	NE	NE
far	NE	NE
fas	NE	ES
fba	NE	GD
fbiA	NE	NE
fbiB	NE	NE
fbiC	NE	NE
fbpA	ES	NE
fbpB	NE	GA
fbpC	NE	NE
fbpD	ES	NE
fdhD	NE	NE
fdhF	NE	NE
fdxA	NE	NE
fdxB	NE	NE
fdxC	NE	ES
fdxD	NE	NE
fecB	NE	NE
ffh	NE	ES
fgd1	NE	NE
fgd2	NE	NE
fic	NE	NE
fixA	ES	GD
fixB	ES	GD
fmt	NE	NE
fmu	NE	NE
folB	ES	GD
folC	ES	ES
folD	NE	ES
folE	GD	ES
folK	GD	GD
folP1	ES	ES
folP2	GD	NE
fpg	GD	NE
fprA	NE	NE
fprB	NE	NE
frdA	NE	NE
frdD	NE	NE
frr	GD	ES
ftsE	NE	NE
ftsH	NE	NE
ftsK	NE	ES
ftsQ	ES	NE
ftsW	ES	ES
ftsX	NE	NE
ftsY	NE	ES
ftsZ	ES	ES
fucA	NE	NE
fum	NE	ES
fusA1	ES	ES
gabD1	NE	NE
gabD2	NE	NE
gabP	NE	NE
gabT	NE	NE
gadB	NE	GA
galE1	ES	ES
galE2	NE	NE
galE3	NE	NE
galK	NE	NE
galU	NE	ES
gap	ES	GD
gatA	N/A	ES
gatB	NE	ES
gatC	NE	N/A
gca	NE	NE
gcpE	NE	ES
gcvB	NE	ES
gcvH	NE	ES
gcvT	NE	ES
gdh	ES	NE
ggtA	NE	NE
ggtB	NE	NE
gid	NE	NE
glbN	NE	NE
glbO	NE	NE
glcB	NE	ES
glf	NE	ES
glgB	ES	ES
glgC	NE	NE
glgE	NE	ES
glgP	NE	NE
glmS	NE	ES
glmU	ES	ES
glnA1	GD	ES
glnA2	NE	NE
glnA3	NE	NE
glnA4	ES	NE
glnB	NE	NE
glnD	NE	NE
glnE	ES	GD
glnH	NE	NE
glnQ	NE	NE
glpD1	NE	NE
glpD2	NE	ES
glpQ1	NE	GA
glpQ2	NE	NE
gltA2	NE	GD
gltB	NE	ES
gltD	ES	ES
gltS	NE	ES
glyA1	ES	ES
glyA2	NE	NE
glyS	NE	ES
gmhA	NE	NE
gmk	ES	NE
gnd1	NE	GA
gnd2	NE	ES
gpdA1	NE	NE
gpdA2	NE	NE
gpm1	NE	NE
gpm2	NE	NE
gpsI	NE	ES
grcC1	NE	ES
grcC2	NE	NE
greA	NE	NE
groEL1	ES	NE
groEL2	NE	ES
groES	NE	ES
grpE	GA	ES
gshA	NE	NE
guaA	GD	ES
guaB1	NE	GA
guaB2	NE	ES
guaB3	NE	GD
gyrA	GD	ES
gyrB	ES	ES
hab	NE	NE
hbhA	NE	GA
helY	NE	NE
helZ	NE	NE
hemA	ES	ES
hemB	NE	ES
hemC	ES	ES
hemD	ES	GD
hemE	NE	ES
hemK	NE	GD
hemL	ES	ES
hemN	GA	NE
hemY	ES	ES
hemZ	NE	ES
hflX	NE	NE
hisA	NE	GD
hisB	ES	GD
hisC1	ES	ES
hisC2	NE	NE
hisD	ES	ES
hisE	NE	ES
hisF	ES	ES
hisG	GD	ES
hisH	ES	GD
hisI	NE	ES
hisS	ES	GD
hns	NE	NE
hpt	ES	ES
hpx	NE	NE
hrcA	NE	NE
hsdM	NE	NE
hsdS	NE	NE
hsp	NE	NE
hspR	GA	NE
hspX	NE	NE
htpG	NE	NE
htpX	NE	NE
htrA	NE	ES
hupB	ES	GD
hycD	NE	NE
hycE	GD	NE
hycP	NE	NE
hycQ	GD	NE
icd1	NE	NE
icd2	NE	NE
ideR	NE	ES
idi	NE	NE
idsA1	NE	NE
idsA2	ES	NE
idsB	NE	NE
ileS	NE	ES
ilvA	NE	ES
ilvB1	NE	ES
ilvB2	NE	NE
ilvC	ES	ES
ilvD	NE	ES
ilvE	NE	ES
ilvG	NE	NE
ilvN	ES	NE
ilvX	NE	NE
impA	ES	NE
infA	NE	NE
infB	NE	ES
infC	NE	ES
inhA	ES	ES
iniA	NE	NE
iniB	NE	NE
iniC	NE	NE
ino1	NE	ES
iscS	NE	GD
ispD	ES	GD
ispE	NE	ES
ispF	ES	GD
iunH	NE	NE
kasA	ES	ES
kasB	GD	NE
katG	NE	NE
kdpA	NE	NE
kdpB	NE	NE
kdpC	NE	NE
kdpD	NE	NE
kdpE	NE	NE
kdpF	NE	NE
kdtB	NE	NE
ksgA	ES	NE
lat	NE	GA
lepA	NE	NE
lepB	NE	ES
leuA	NE	ES
leuB	ES	ES
leuC	NE	GD
leuD	ES	GD
leuS	NE	ES
lexA	NE	ES
lgt	NE	ES
lhr	NE	NE
ligA	NE	ES
ligB	NE	NE
ligC	NE	NE
lipA	NE	ES
lipB	GD	ES
lipC	NE	NE
lipD	NE	GA
lipE	NE	NE
lipF	GA	GA
lipG	ES	GA
lipI	NE	NE
lipJ	NE	NE
lipL	NE	NE
lipM	NE	NE
lipN	NE	NE
lipO	NE	NE
lipP	NE	NE
lipQ	NE	NE
lipR	NE	NE
lipT	NE	NE
lipU	NE	NE
lipV	NE	NE
lipW	NE	NE
lldD2	NE	NE
lpdA	NE	NE
lppA	NE	NE
lppB	NE	NE
lppC	NE	NE
lppD	NE	NE
lppE	NE	GA
lppF	NE	NE
lppG	NE	NE
lppH	NE	NE
lppI	NE	NE
lppJ	NE	NE
lppK	NE	NE
lppL	ES	GD
lppM	ES	NE
lppN	NE	NE
lppP	NE	NE
lppQ	GA	NE
lppR	NE	NE
lppT	NE	NE
lppU	NE	NE
lppV	NE	NE
lppW	ES	NE
lppX	N/A	NE
lppY	NE	NE
lppZ	NE	ES
lpqA	NE	NE
lpqB	ES	GD
lpqC	NE	NE
lpqD	NE	NE
lpqE	NE	NE
lpqF	NE	NE
lpqG	ES	NE
lpqH	ES	NE
lpqI	NE	NE
lpqJ	NE	NE
lpqK	NE	NE
lpqL	NE	NE
lpqM	NE	NE
lpqN	NE	NE
lpqO	NE	NE
lpqP	NE	NE
lpqQ	NE	NE
lpqR	NE	NE
lpqS	NE	NE
lpqT	ES	NE
lpqU	ES	NE
lpqV	NE	NE
lpqW	NE	ES
lpqX	ES	NE
lpqY	NE	NE
lpqZ	NE	NE
lprA	NE	NE
lprB	GD	NE
lprC	GD	NE
lprD	NE	GD
lprE	NE	NE
lprF	NE	NE
lprG	NE	NE
lprH	NE	NE
lprI	NE	NE
lprJ	NE	NE
lprK	NE	NE
lprL	NE	NE
lprN	NE	NE
lprO	GD	NE
lprP	NE	NE
lprQ	GA	GA
lspA	NE	GD
lsr2	ES	GD
ltp1	NE	NE
ltp2	NE	NE
lysA	ES	ES
lysS	NE	ES
lysX	NE	NE
lytB2	NE	ES
malQ	ES	GA
manA	ES	ES
manB	NE	ES
mapA	NE	NE
mapB	NE	NE
mas	GA	NE
mbtA	NE	NE
mbtB	NE	NE
mbtC	NE	NE
mbtD	GD	NE
mbtE	NE	NE
mbtF	NE	NE
mbtG	NE	NE
mbtI	GA	GD
mbtJ	GD	NE
mca	NE	NE
mce1A	NE	NE
mce1B	NE	NE
mce1C	NE	NE
mce1D	NE	NE
mce1F	NE	NE
mce2A	NE	NE
mce2C	NE	NE
mce2F	NE	NE
mce4A	NE	NE
mce4B	NE	NE
mce4C	NE	NE
mce4D	NE	NE
mce4F	NE	NE
mcr	NE	GA
mdh	NE	NE
menA	NE	ES
menB	NE	ES
menC	NE	ES
menD	ES	ES
menE	ES	ES
menH	GA	ES
mesJ	NE	ES
metA	GA	ES
metB	NE	NE
metC	ES	NE
metE	NE	ES
metH	NE	NE
metK	NE	ES
metS	NE	ES
metZ	NE	NE
mez	NE	NE
mfd	NE	NE
mgtE	ES	GA
mhpE	NE	NE
miaA	NE	GD
mihF	GD	NE
mkl	NE	GA
mmaA1	GA	GA
mmaA2	GA	GA
mmaA3	GA	GA
mmaA4	GA	GA
mmpL10	GD	NE
mmpL11	NE	NE
mmpL12	NE	NE
mmpL2	NE	NE
mmpL3	NE	ES
mmpL4	NE	NE
mmpL5	NE	NE
mmpL6	NE	NE
mmpL7	NE	NE
mmpL8	NE	NE
mmpS1	NE	NE
mmpS2	NE	NE
mmpS3	NE	NE
mmpS4	NE	NE
mmpS5	NE	NE
mmr	NE	NE
mmsA	NE	NE
mmsB	NE	NE
mmuM	NE	GA
mntH	NE	NE
moaA1	NE	NE
moaA2	NE	NE
moaB1	NE	NE
moaB2	NE	NE
moaC1	NE	NE
moaC2	NE	NE
moaC3	NE	NE
moaD1	NE	NE
moaD2	NE	NE
moaE2	NE	GA
moaX	NE	NE
mobA	NE	NE
modA	NE	GA
modB	NE	NE
modC	NE	NE
moeA1	NE	NE
moeA2	NE	NE
moeB1	NE	ES
moeB2	NE	NE
moeW	NE	NE
moeX	NE	NE
moeY	NE	NE
mog	NE	NE
moxR1	GD	ES
moxR2	NE	NE
moxR3	NE	NE
mprB	NE	ES
mpt63	NE	GA
mqo	NE	NE
mrp	NE	ES
mrr	NE	NE
mrsA	ES	ES
mscL	NE	NE
mshB	NE	NE
msrA	NE	NE
mtc28	ES	NE
mtn	NE	NE
mtr	NE	NE
mtrA	GD	ES
mtrB	ES	GD
murA	ES	ES
murB	GA	ES
murC	ES	ES
murE	NE	ES
murF	ES	ES
murG	ES	ES
murI	ES	ES
murX	ES	ES
mutA	NE	NE
mutB	NE	NE
mutT1	ES	NE
mutT2	NE	NE
mutT3	GD	NE
mutY	NE	NE
nadA	ES	ES
nadB	GD	ES
nadC	NE	ES
nadD	NE	ES
nadE	ES	GD
nadR	NE	NE
nagA	NE	NE
nanT	NE	NE
narG	NE	NE
narH	NE	NE
narI	NE	NE
narJ	NE	NE
narK1	NE	NE
narK2	NE	NE
narK3	NE	NE
narL	NE	NE
narU	NE	GA
narX	NE	NE
nat	NE	NE
ndh	NE	GD
ndhA	NE	NE
ndkA	NE	NE
nei	NE	NE
nicT	NE	NE
nirB	NE	NE
nirD	NE	NE
nrdB	NE	NE
nrdE	NE	ES
nrdF1	NE	GA
nrdF2	NE	GD
nrdH	NE	ES
nrdI	ES	ES
nrdZ	NE	NE
nrp	ES	NE
nth	NE	NE
nudC	NE	NE
nuoA	NE	NE
nuoB	NE	NE
nuoC	NE	NE
nuoD	NE	NE
nuoE	NE	NE
nuoF	NE	NE
nuoG	NE	NE
nuoH	NE	NE
nuoI	NE	NE
nuoJ	NE	NE
nuoK	NE	NE
nuoL	NE	NE
nuoM	NE	NE
nuoN	NE	NE
nusA	GD	ES
nusB	NE	ES
nusG	ES	ES
obg	ES	ES
ogt	GA	NE
omt	NE	NE
opcA	NE	NE
oplA	NE	NE
oppA	NE	NE
oppB	NE	NE
oppC	NE	NE
oppD	NE	NE
orn	NE	NE
otsA	NE	GD
otsB1	NE	NE
otsB2	NE	ES
oxcA	NE	NE
oxyS	NE	NE
panB	NE	ES
panC	NE	ES
panD	ES	ES
papA1	NE	NE
papA2	NE	NE
papA3	NE	NE
papA4	NE	NE
papA5	GA	NE
parA	NE	ES
parB	ES	ES
pbpA	NE	NE
pbpB	ES	ES
pca	ES	NE
pcaA	NE	NE
pcd	NE	NE
pckA	NE	NE
pcnA	NE	ES
pcp	NE	NE
pdc	NE	NE
pdxH	NE	NE
PE_PGRS1	NE	NE
PE_PGRS10	NE	NE
PE_PGRS11	NE	NE
PE_PGRS12	NE	NE
PE_PGRS13	NE	NE
PE_PGRS14	NE	NE
PE_PGRS15	NE	NE
PE_PGRS16	NE	GA
PE_PGRS17	NE	GA
PE_PGRS18	NE	GA
PE_PGRS19	NE	NE
PE_PGRS2	NE	NE
PE_PGRS20	NE	NE
PE_PGRS21	NE	NE
PE_PGRS22	ES	NE
PE_PGRS23	NE	NE
PE_PGRS24	ES	NE
PE_PGRS25	NE	NE
PE_PGRS26	NE	NE
PE_PGRS27	ES	NE
PE_PGRS28	NE	GA
PE_PGRS29	NE	NE
PE_PGRS30	ES	NE
PE_PGRS31	NE	NE
PE_PGRS33	NE	NE
PE_PGRS34	NE	NE
PE_PGRS35	NE	GA
PE_PGRS38	ES	NE
PE_PGRS39	GA	NE
PE_PGRS4	NE	NE
PE_PGRS40	NE	NE
PE_PGRS41	ES	GA
PE_PGRS44	NE	NE
PE_PGRS45	NE	NE
PE_PGRS46	NE	NE
PE_PGRS47	NE	NE
PE_PGRS48	NE	NE
PE_PGRS5	NE	NE
PE_PGRS51	NE	NE
PE_PGRS52	NE	NE
PE_PGRS53	GD	NE
PE_PGRS54	NE	NE
PE_PGRS55	NE	NE
PE_PGRS57	NE	NE
PE_PGRS58	NE	NE
PE_PGRS59	ES	NE
PE_PGRS60	NE	NE
PE_PGRS61	NE	NE
PE_PGRS62	NE	NE
PE_PGRS7	NE	NE
PE_PGRS9	NE	NE
PE1	NE	GA
PE12	GD	NE
PE13	GA	GA
PE14	NE	NE
PE15	NE	NE
PE16	NE	NE
PE17	NE	NE
PE18	NE	GA
PE19	NE	NE
PE2	NE	GA
PE20	NE	NE
PE22	NE	NE
PE23	NE	NE
PE24	NE	NE
PE25	NE	NE
PE26	NE	NE
PE27	NE	NE
PE29	NE	NE
PE3	NE	GA
PE31	NE	NE
PE33	NE	NE
PE34	NE	NE
PE35	NE	NE
PE36	NE	NE
PE4	NE	GA
PE5	ES	ES
PE6	NE	NE
PE7	NE	NE
PE8	NE	GA
PE9	NE	NE
pepA	NE	NE
pepB	NE	NE
pepC	NE	NE
pepE	NE	NE
pepN	NE	NE
pepQ	NE	NE
pepR	ES	NE
pfkA	ES	NE
pfkB	NE	NE
pflA	NE	NE
pgi	NE	NE
pgk	ES	GD
pgmA	NE	NE
pgsA1	NE	NE
pgsA2	NE	ES
pgsA3	NE	ES
pheA	NE	ES
pheS	ES	ES
pheT	NE	ES
phoH1	NE	NE
phoH2	NE	NE
phoP	NE	NE
phoR	NE	NE
phoT	NE	GA
phoY1	NE	NE
phoY2	NE	GA
php	NE	GA
phyA	NE	NE
pimA	ES	ES
pimB	ES	ES
pip	NE	NE
pirG	NE	NE
pitA	NE	NE
pitB	NE	NE
pknA	ES	ES
pknB	ES	ES
pknE	NE	NE
pknF	NE	NE
pknG	NE	NE
pknI	NE	NE
pknJ	NE	NE
pknK	NE	NE
pknL	NE	NE
pks1	NE	NE
pks10	NE	NE
pks11	NE	NE
pks12	NE	NE
pks13	ES	ES
pks16	ES	NE
pks17	NE	NE
pks2	NE	NE
pks3	NE	NE
pks5	NE	NE
pks7	NE	NE
pks8	NE	NE
pks9	NE	NE
plsB1	NE	NE
plsB2	NE	NE
plsC	NE	NE
pmmB	NE	NE
pncA	NE	NE
pntAa	N/A	GA
pntAb	NE	GA
pntB	NE	GA
polA	ES	GD
ponA1	NE	NE
ponA2	NE	GA
ppa	NE	ES
ppdK	NE	NE
PPE1	NE	NE
PPE10	NE	NE
PPE11	NE	NE
PPE12	NE	GD
PPE13	NE	GA
PPE14	GD	NE
PPE15	NE	GA
PPE16	NE	NE
PPE18	GA	GA
PPE19	NE	NE
PPE2	NE	NE
PPE20	GD	NE
PPE21	NE	NE
PPE22	NE	NE
PPE23	NE	NE
PPE24	NE	NE
PPE25	NE	GA
PPE26	NE	GA
PPE27	NE	GA
PPE28	NE	NE
PPE29	NE	NE
PPE3	NE	NE
PPE30	NE	NE
PPE32	NE	GA
PPE34	NE	NE
PPE36	ES	NE
PPE37	NE	NE
PPE4	ES	ES
PPE41	NE	NE
PPE42	NE	NE
PPE43	NE	NE
PPE44	GA	NE
PPE45	NE	NE
PPE46	N/A	NE
PPE49	NE	NE
PPE5	NE	NE
PPE50	NE	NE
PPE51	NE	NE
PPE52	NE	NE
PPE53	NE	NE
PPE54	NE	NE
PPE57	NE	NE
PPE6	NE	NE
PPE60	NE	NE
PPE61	NE	NE
PPE62	NE	NE
PPE63	NE	NE
PPE64	NE	NE
PPE66	NE	GA
PPE68	NE	NE
PPE69	NE	NE
PPE8	NE	GA
ppgK	ES	NE
ppiA	NE	NE
ppiB	NE	GD
ppm1	NE	NE
ppnK	NE	ES
ppsA	GA	NE
ppsB	GA	NE
ppsC	NE	NE
ppsD	NE	NE
ppsE	NE	NE
prcA	ES	GD
prcB	ES	GD
prfA	NE	ES
prfB	NE	ES
priA	NE	ES
proA	NE	NE
proB	ES	ES
proC	NE	ES
proS	ES	ES
proV	NE	NE
proW	NE	NE
proX	NE	NE
proZ	NE	NE
prrA	GD	ES
prrB	GD	ES
prsA	ES	ES
psd	NE	NE
pssA	NE	NE
pstA1	NE	NE
pstA2	NE	NE
pstC1	NE	NE
pstC2	NE	NE
pstS1	NE	NE
pstS2	NE	NE
pstS3	GD	NE
pta	NE	NE
ptbB	NE	GA
pth	NE	GD
ptpA	ES	NE
purA	NE	ES
purB	NE	ES
purC	NE	ES
purD	NE	ES
purE	ES	GD
purF	GD	GD
purH	NE	ES
purK	NE	GD
purL	NE	ES
purM	NE	GD
purN	ES	ES
purQ	NE	ES
purT	NE	NE
purU	NE	NE
pykA	NE	GD
pyrB	ES	ES
pyrC	ES	ES
pyrD	NE	ES
pyrE	ES	ES
pyrF	NE	ES
pyrG	ES	ES
pyrH	NE	ES
pyrR	ES	NE
qcrA	ES	GD
qcrB	NE	GD
qcrC	ES	GD
qor	NE	GA
radA	NE	NE
rbfA	ES	NE
rbsK	NE	NE
recA	NE	NE
recC	NE	NE
recD	NE	NE
recF	NE	NE
recG	NE	NE
recN	ES	NE
recR	NE	NE
recX	NE	NE
regX3	NE	NE
relA	NE	NE
rfbD	NE	ES
rfe	GD	ES
rhlE	ES	NE
rho	GA	ES
ribA1	NE	NE
ribA2	ES	ES
ribC	NE	NE
ribD	NE	NE
ribF	NE	ES
ribG	NE	ES
ribH	NE	ES
rimI	NE	NE
rimJ	NE	NE
rimM	ES	GD
rmlA	GD	ES
rmlC	NE	ES
rnc	GD	ES
rne	NE	GD
rnhB	ES	NE
rnpA	ES	NE
rocA	NE	NE
rocE	NE	NE
rodA	ES	NE
rpe	NE	GD
rpfA	NE	GA
rpfB	NE	NE
rpfC	NE	GA
rpfD	GA	NE
rpfE	NE	NE
rphA	NE	NE
rplA	GA	ES
rplB	ES	ES
rplC	ES	ES
rplD	ES	ES
rplE	ES	ES
rplF	ES	ES
rplI	NE	NE
rplJ	NE	ES
rplK	GD	NE
rplL	NE	NE
rplM	NE	ES
rplN	ES	ES
rplO	NE	NE
rplP	GD	ES
rplQ	GD	GD
rplR	ES	ES
rplS	NE	NE
rplT	NE	ES
rplU	NE	NE
rplV	ES	ES
rplW	ES	ES
rplX	ES	ES
rplY	NE	GD
rpmA	ES	NE
rpmB1	NE	NE
rpmB2	NE	GA
rpmC	GD	GD
rpmD	NE	NE
rpmE	ES	NE
rpmF	NE	GA
rpmG1	NE	GA
rpmG2	ES	GD
rpmH	ES	NE
rpmI	NE	NE
rpmJ	NE	NE
rpoA	ES	GD
rpoB	ES	ES
rpoC	NE	ES
rpoZ	ES	GD
rpsA	NE	GD
rpsB	NE	ES
rpsC	ES	ES
rpsD	ES	ES
rpsE	ES	ES
rpsF	NE	NE
rpsG	ES	ES
rpsH	ES	ES
rpsI	ES	ES
rpsJ	ES	NE
rpsK	ES	ES
rpsL	ES	ES
rpsM	NE	ES
rpsN1	ES	ES
rpsN2	NE	GA
rpsO	ES	NE
rpsP	NE	GD
rpsQ	NE	GD
rpsR1	NE	ES
rpsR2	NE	GA
rpsS	ES	ES
rpsT	ES	ES
rsbW	NE	GA
ruvA	ES	GD
ruvB	ES	GD
ruvC	N/A	GD
sahH	NE	ES
scoA	NE	NE
scoB	NE	NE
sdaA	NE	NE
sdhA	NE	NE
sdhB	NE	NE
sdhC	NE	NE
sdhD	NE	NE
secA1	NE	ES
secA2	ES	NE
secD	NE	ES
secE1	ES	ES
secE2	NE	NE
secF	ES	GD
secG	NE	NE
secY	ES	ES
senX3	NE	NE
serA1	NE	ES
serA2	NE	NE
serB1	NE	NE
serB2	ES	ES
serC	NE	ES
serS	NE	ES
sigA	NE	ES
sigB	NE	NE
sigC	NE	NE
sigD	NE	NE
sigE	NE	NE
sigF	NE	GA
sigG	NE	NE
sigH	NE	NE
sigI	NE	NE
sigJ	NE	NE
sigK	NE	NE
sigL	NE	NE
sirR	NE	NE
smc	NE	NE
smpB	NE	NE
sodA	NE	ES
sodC	NE	NE
speE	NE	NE
spoU	NE	NE
sppA	NE	NE
ssb	NE	ES
sseA	NE	NE
sseB	NE	NE
sthA	NE	GA
subI	NE	GD
sucC	ES	ES
sucD	NE	ES
sugA	NE	NE
sugB	NE	NE
sugC	NE	NE
sugI	NE	NE
suhB	NE	NE
tagA	NE	NE
tal	ES	NE
tam	NE	NE
tatA	NE	NE
tatB	NE	GD
tatC	NE	GD
tatD	NE	NE
TB15.3	NE	ES
TB16.3	NE	NE
TB18.5	NE	ES
TB18.6	NE	NE
TB22.2	NE	NE
TB27.3	NE	NE
TB31.7	NE	NE
TB7.3	NE	NE
TB9.4	NE	NE
tcrA	NE	NE
tesA	GA	NE
tesB1	GD	NE
tesB2	NE	NE
thiC	NE	ES
thiD	ES	GD
thiE	ES	ES
thiG	NE	ES
thiL	NE	ES
thiO	ES	ES
thiS	ES	ES
thiX	ES	GA
thrA	ES	ES
thrB	ES	ES
thrC	ES	ES
thrS	NE	ES
thyA	NE	GD
tig	NE	NE
tkt	NE	ES
tlyA	ES	NE
tmk	ES	ES
topA	NE	ES
tpi	NE	ES
tpx	NE	NE
trcR	NE	GA
trcS	NE	NE
treS	NE	NE
treX	ES	NE
treZ	GD	NE
trmD	ES	GD
trmU	ES	NE
trpA	ES	ES
trpB	ES	ES
trpC	ES	ES
trpD	ES	GD
trpE	NE	ES
trpG	ES	ES
trpS	NE	ES
truA	GD	GD
truB	GD	NE
trxA	NE	NE
trxB1	NE	NE
trxB2	NE	ES
trxC	ES	NE
tsf	ES	ES
tsnR	NE	GA
tuf	NE	ES
typA	ES	NE
tyrA	NE	ES
tyrS	NE	ES
udgA	NE	NE
ufaA1	NE	NE
ugpB	NE	NE
ugpC	NE	NE
ugpE	NE	NE
ung	NE	NE
upp	NE	NE
ureA	NE	NE
ureB	NE	NE
ureC	NE	NE
ureD	ES	NE
ureF	NE	NE
ureG	NE	NE
usfY	NE	GA
uspA	NE	NE
uspB	NE	NE
uspC	NE	NE
uvrA	NE	NE
uvrB	NE	NE
uvrC	NE	NE
uvrD1	NE	NE
valS	NE	ES
virS	NE	NE
viuB	NE	NE
wag31	NE	ES
wbbL1	ES	GD
wbbL2	NE	NE
whiA	NE	ES
whiB1	NE	GD
whiB2	GD	NE
whiB3	ES	NE
whiB4	ES	NE
whiB5	ES	NE
whiB6	NE	NE
whiB7	ES	NE
xerC	NE	NE
xseA	NE	NE
xseB	NE	NE
xthA	NE	NE
xylB	NE	NE
yfiH	ES	NE
yjcE	NE	NE
yrbE1A	NE	NE
yrbE1B	NE	NE
yrbE2A	NE	NE
yrbE3A	NE	NE
yrbE4A	NE	NE
yrbE4B	NE	GA
zwf1	ES	NE
zwf2	NE	NE
